########
#  ..$ #
# $@ $ #
# $..  #
########
