######
#.#.##
# $ ##
#$@$ #
#.   #
######