WWWWWWW
WWW   W
WP GBGW
W  B BW
WWWGBGW
  W   W
  WWWWW