########
#   @  #
# $$#  #
##  $ ##
 #.$  # 
 ##. ## 
  #..#  
  ####  
