########
###    #
###$$$ #
#@ $.. #
# $...##
####  # 
   #### 
