WWWWWWWWW
W   Y   W
W BGWGB W
W  BGB  W
WWWGBGWWW
  WWPWW  
   WWW   