########
##. ..##
##. $.##
###  $##
# $  $ #
# #$## #
#   @  #
########
