######  
##   ###
##$#@ .#
#  $$#.#
# #$  .#
#     .#
########
