WWWWWWW
W    WW
WBBY  W
WGGPGGW
W  YBBW
WW    W
WWWWWWW