WWWWWWWW
W BG BGW
WPGB BGW
W BG BGW
W GB BGW
WWWWWWWW