WWWWWW
WWP  W
W    W
W B GW
WWWWWW