#######
## . @#
# $ $ #
#. + .#
# $ $ #
## . ##
#######
