WWWWWWWW
WW     W
WW GBG W
WP B B W
W  GBG W
WW     W
WWWWWWWW