WWWWWW  
WW   WWW
WWBWP GW
W  BBWGW
W WB  GW
W     GW
WWWWWWWW