WWWWWWWW
W  GGB W
W BP B W
W BGG  W
WWWWWWWW