#########
#   +   #
# $ .$  #
#.+++..+#
# $@+ $ #
#   +   #
#########
