#######
###   #
#@ .$.#
#  $ $#
###.$.#
  #   #
  #####
