WWWWWWWW
W  W   W
W BGGB W
WPBGY WW
W BGGB W
W  W   W
WWWWWWWW