#######
#    ##
#$$+  #
#..@..#
#  +$$#
##    #
#######
