######## 
#    @ # 
# $..  ##
###..#  #
  ##$$$ #
   #    #
   ######
