########
##    ##
# $ $$ #
#......#
# $$ $ #
### @###
########
