#########
##  . @##
##$$.$$##
# ..+.. #
# $$.$$ #
#   .   #
#########
