########
#  #   #
# $..$ #
#@$.+ ##
# $..$ #
#  #   #
########
