######  
##   ###
#  #   #
# #  # #
# $ $# #
#.#    #
#. @####
#####   
