#########
###   ###
# $.$.$ #
#  .+. @#
# $.$.$ #
###   ###
#########
