########
##     #
## .$. #
#@ $ $ #
#  .$. #
##     #
########
