WWWWWWWW 
W    P W 
W BGG  WW
WWWGGW  W
  WWBBB W
   W    W
   WWWWWW