WWWWWWW
WG G GW
W BBB W
WGBPBGW
W BBB W
WG G GW
WWWWWWW