WWWWWWWWW
WW  G PWW
WWBBGBBWW
W GGYGG W
W BBGBB W
W   G   W
WWWWWWWWW