WWWWWWWW
WWW    W
WWWBBB W
WP BGG W
W BGGGWW
WWWW  W 
   WWWW 