WWWWWW  
WW   WWW
W  W   W
W W  W W
W B BW W
WGW    W
WG PWWWW
WWWWW   