WWWWWWW
WG B GW
W BPB W
WG B GW
WWWWWWW