WWWWWWWW
WW    WW
W B BB W
WGGGGGGW
W BB B W
WWW PWWW
WWWWWWWW