#########
#   +   #
# $.#.$ #
#  $.$  #
###.$.###
  ##@##  
   ###   
